{
    "width": 20,
    "height": 20,
    "tileWidth": 32,
    "tileHeight": 32,
    "layouts": [
        {
            "tiles": [
                [1,2,1,2,1,2,1,2,1,2,1,2,1,2,1,2,1,2,1,2],
                [9,10,9,10,9,10,9,10,9,10,9,10,9,10,9,10,9,10,9,10],
                [1,2,1,2,1,2,1,2,1,2,1,2,1,2,1,2,1,2,1,2],
                [9,10,9,10,9,10,9,10,9,10,9,10,9,10,9,10,9,10,9,10],
                [1,2,1,2,1,2,1,2,1,2,1,2,1,2,1,2,1,2,1,2],
                [9,10,9,10,9,10,9,10,9,10,9,10,9,10,9,10,9,10,9,10],
                [1,2,1,2,1,2,1,2,1,2,1,2,1,2,1,2,1,2,1,2],
                [9,10,9,10,9,10,9,10,9,10,9,10,9,10,9,10,9,10,9,10],
                [1,2,1,2,1,2,1,2,1,2,1,2,1,2,1,2,1,2,1,2],
                [9,10,9,10,9,10,9,10,9,10,9,10,9,10,9,10,9,10,9,10],
                [1,2,1,2,1,2,1,2,1,2,1,2,1,2,1,2,1,2,1,2],
                [9,10,9,10,9,10,9,10,9,10,9,10,9,10,9,10,9,10,9,10],
                [1,2,1,2,1,2,1,2,1,2,1,2,1,2,1,2,1,2,1,2],
                [9,10,9,10,9,10,9,10,9,10,9,10,9,10,9,10,9,10,9,10],
                [1,2,1,2,1,2,1,2,1,2,1,2,1,2,1,2,1,2,1,2],
                [9,10,9,10,9,10,9,10,9,10,9,10,9,10,9,10,9,10,9,10],
                [1,2,1,2,1,2,1,2,1,2,1,2,1,2,1,2,1,2,1,2],
                [9,10,9,10,9,10,9,10,9,10,9,10,9,10,9,10,9,10,9,10],
                [1,2,1,2,1,2,1,2,1,2,1,2,1,2,1,2,1,2,1,2],
                [9,10,9,10,9,10,9,10,9,10,9,10,9,10,9,10,9,10,9,10]
            ]
        },
        {
            "tiles": [
                [0,0,0,0,0,0,0,0,0,0,0,0,0,0,0,0,0,0,0,0],
                [0,0,0,0,0,0,0,0,0,0,0,0,0,0,0,0,0,0,30,0],
                [0,30,0,0,0,0,0,0,0,0,0,0,30,0,0,0,0,0,0,0],
                [0,0,0,0,0,0,0,0,0,0,0,0,0,0,0,0,0,0,0,0],
                [0,0,0,0,0,0,0,0,0,0,0,0,0,0,0,0,0,0,30,0],
                [0,0,0,0,0,0,0,0,30,0,0,0,0,0,0,0,0,0,0,0],
                [0,0,0,0,0,0,0,0,0,0,0,0,0,0,0,0,0,0,0,0],
                [0,0,30,0,0,0,0,0,0,0,0,0,0,0,0,0,0,0,0,0],
                [0,0,0,0,0,0,0,0,0,0,0,0,30,0,0,0,0,0,0,0],
                [0,0,0,0,0,0,0,0,0,0,0,0,0,0,0,0,0,0,0,0],
                [0,0,0,0,0,0,0,0,0,0,0,0,0,0,0,0,0,0,0,0],
                [0,0,0,0,0,0,0,0,0,0,0,0,0,0,0,0,0,0,30,0],
                [0,30,0,0,0,0,0,0,0,0,0,0,30,0,0,0,0,0,0,0],
                [0,0,0,0,0,0,0,0,0,0,0,0,0,0,0,0,0,0,0,0],
                [0,0,0,0,0,0,0,0,0,0,0,0,0,0,0,0,0,0,30,0],
                [0,0,0,0,0,0,0,0,30,0,0,0,0,0,0,0,0,0,0,0],
                [0,0,0,0,0,0,0,0,0,0,0,0,0,0,0,0,0,0,0,0],
                [0,0,30,0,0,0,0,0,0,0,0,0,0,0,0,0,0,0,0,0],
                [0,0,0,0,0,0,0,0,0,0,0,0,30,0,0,0,0,0,0,0],
                [0,0,0,0,0,0,0,0,0,0,0,0,0,0,0,0,0,0,0,0]
            ]
        }
    ],
    "walls": [
        [1,1,1,1,1,1,1,1,1,1,1,1,1,1,1,1,1,1,1,1],
        [1,0,0,0,0,0,0,0,0,0,0,0,0,0,0,0,0,0,0,1],
        [1,0,0,0,0,0,0,0,0,0,0,0,0,0,0,0,0,0,0,1],
        [1,0,0,0,0,0,0,0,0,0,0,0,0,0,0,0,0,0,0,1],
        [1,0,0,0,0,0,0,0,0,0,0,0,0,0,0,0,0,0,0,1],
        [1,0,0,0,0,0,0,0,0,0,0,0,0,0,0,0,0,0,0,1],
        [1,0,0,0,0,0,0,0,0,0,0,0,0,0,0,0,0,0,0,1],
        [1,0,0,0,0,0,0,0,0,0,0,0,0,0,0,0,0,0,0,1],
        [1,0,0,0,0,0,0,0,0,0,0,0,0,0,0,0,0,0,0,1],
        [1,0,0,0,0,0,0,0,0,0,0,0,0,0,0,0,0,0,0,1],
        [1,0,0,0,0,0,0,0,0,0,0,0,0,0,0,0,0,0,0,1],
        [1,0,0,0,0,0,0,0,0,0,0,0,0,0,0,0,0,0,0,1],
        [1,0,0,0,0,0,0,0,0,0,0,0,0,0,0,0,0,0,0,1],
        [1,0,0,0,0,0,0,0,0,0,0,0,0,0,0,0,0,0,0,1],
        [1,0,0,0,0,0,0,0,0,0,0,0,0,0,0,0,0,0,0,1],
        [1,0,0,0,0,0,0,0,0,0,0,0,0,0,0,0,0,0,0,1],
        [1,0,0,0,0,0,0,0,0,0,0,0,0,0,0,0,0,0,0,1],
        [1,0,0,0,0,0,0,0,0,0,0,0,0,0,0,0,0,0,0,1],
        [1,0,0,0,0,0,0,0,0,0,0,0,0,0,0,0,0,0,0,1],
        [1,1,1,1,1,1,1,1,1,1,1,1,1,1,1,1,1,1,1,1]
    ]
}
